WE texture/001_height.png
NO texture/001_height.png

SO texture/001_height.png


EA texture/001_height.png

F 100,00000000000000,00000000000000
C 00000000000000,00000000000000,00000000000000

111111
110N01
111111
