

SO	./texture/004_basecolor.png
NO	texture/004_height.png

EA texture/001_height.png
WE texture/Blue_glazed_pxr128_bmp.png
F	32,32,32
C	36,220,240



1111111111111111111111111
100000S00001100000000000011
10110000011100000000000011
1001000000000000000000001
1111111110110000011100001
10000000000000000111011111
1111111111111111111111111
1111000000000101110000001
1111010001001100001010001
1111011111001111001111111
1100000011010101000000001
1000000000000000000000001
1000000000000000000101001
1100001000000100000000001
1111011111110101110111101
11111111 1111111111111111
11111111 1111111111111111
